WEWEEEEWEEEWEEEWEEEWEEEEEEEEEEWEEEEWEEEEEEEEWEEEEWWWEEEWWWWWEEEEED
WWEWEEWWEEWWEEWWEEWWEEWWEEEEEWWEEEWEEWWWWWEEWEEEWEEWEEWEEEEEEEEEEE
EWEWWEWEWEWEWEWEWEWEWEWEWEEEEWEWEEWEEWEEEEWEEWWWWEWEWEWEEWEEEWEEEW
EEWEWWEEWWEEWWEEWWEEWWEEWWEEWWWWEEWEEWEWEWEEEWEEEWEWEWWEWEWWEWEEWE
EEWWEEEEEEEEEEEEEEEEEEEWEEWEEEEEEEEWWWWEEWWWWEWEEWEWEEWEWEWEWEWEWE
EWEWWWWWWWEWWWEWWWWEEEWWEWEEWWWWWEEEEEEEEEEEWEWWEWEWEWWEEWEWEWEEWE
WEWWEEEEEEWEWWEWEEEWEEEEEWEEWEEEEWEEWWEWWWWWEWEWEEWEWEWEEWEEWEWEWE
WEWEWWWWWEWEWEWWWWWWWWWEEWEEWEWWEWWEWEWEEEEWEWEEWWEWEEEEEWEWEWEWEE
EEEEWEEEEWEWEEWEEEEEEEEWEEWEEWEWEEEWEEWEEWEEWEWEWEWEWEEWEWEWEWEEWE
WWWWEWWWEWEWEWEWWWWWWWEWEEWEEWEWWWWWWEEEWWEEWEWWEWEWEEWWEEWEWEEWEW
WEEEEWEEWEWEWWEWEEEEEEWEWEWEWEWEWEEEEEEEWWWEEWEWEWEWEEWEWEWEWEEWEW
WEEEWEEEWEWEEEWEEEEEEEWEWWEWEWEWEEEEEEEEEEEEEWEEEWEWEEWWEEWEWEEWEW
WEWWWEEEWEEWEEWEEWWWWEEWEEEWEWEWEWWWWWWWWWWWEEWEEEWEWEEWEEWEWEEWEW
WEEEEWEWEEEEWEEEWEEEWEEEEEEEWEWEWEEEEEEEEEEWEEWWWWEEWWWEEEWEWEWEWE
WWWEEWEEWEEEWWEEWEWWEWEEWWWWWEWEWEWEEEEEEEWEWEEWEEWEEEEEEEWEWEEWEW
WEWEWEEEWWWEWEEWEEWEEWEWEEEWWWEWEWEWWEEWWEWEWEEWWWWEEEWWEWEWEEWEWE
WEEWEWEEEEEEEEEEWEWWEWEWEWWWEEEWEWEWEWEWEWEWEWEEWEEWEWWEWWEWEEWEWE
WEEWEWEEEEEWEEEEWEEEWEWEWEEWEEWEWEWEEWWEEWEWEWEEWWWWEWEEEWEEEEEWEE
WEEEEEWWWEEWEEWEEWWWWEWEWEEEWEEWEWEWEEWEEWEWEWEEEWEEEEWEWEWWWEEWEE
WEEEEEEEWEEWEEWEEEEEEEEWEWWEWEEWEWEWEEEEWEWEWEEWWEWWWEWEWEEEEWEWEE
WWWWEEEEEWEEWWEWWWWWEEEWEWEWEWEEWEWEWEEEWEWEWEWWEEWEEWEWEWWWEWWEWE
WEEWWWWEEWEWWEEEEEEEEEWEWEEWEWEEWEWEWEEWEWEWEWEWEWEEEWEWEEEWEWEWEE
WEWEEEEEEEWEEWEEEEEWWWWEWEEEWEWWEWEWEWEWEWEWEWWEWEWEEWEEWWWEWEEWEE
WEWEEWWWEEEEEWEEWWWEEEWEWWWWEEEEEWEWEWWEWEWEWEWEWEWWWEEWEEWEWEWEEE
WEEWWEEEWEEWEEWEEEEWWWWWEEEEEWWWEEWEWEWEWEWEEWWEEEEEEEEEEEEWWEWEEW
WEEEWEEEWEEWEWEWEEWEEEEWEEEEWEEEEEWEWEEWEWEWEWEWEEWWWWWWEEEWWEWWWW
WEEWEWEEEWEEWEEEWEWEEWEEWEWWEWEWWWEWEEEEEWEWWWWWWEWEEEEEWEEEWEEWEW
WEEWEWEWEWWEWEEWWEWEEWEEWWEWEWEEEWEWWWWWWEWEWEWEWWEWWWWWEWWEWEEWEE
WEEEWWEWWEEEEEEEWEEWEEWEEWEEWEWEEWEWEEEEEEEEEEEEEEEEEEEWEWEWEWEEWE
EWEEWEWEWEEWEWEWEEWEEWEEWEWEWEWEEEWEEWEWWWWWWEWWWWWWWEEWEWWEEWEEWW
EWEEEEWEEWWWEEWEEEWEEWEEWEWWEWEWWWWEEWEWWEEEEEEEEEEWEWEEWEEEWEWEWW
EWEEEWWEWEEEEEWWWWEEEEEWEWEWEWEEEEEEWEWEWWWWWEWWWWWEEWEEWEWEWEWEWW
WEWEEWEWWEEEEEWEEEWWWWWWEEWEWEWWWWEEWEWEWEEEEEEEEEEWEEWEWEWEWEWEEW
WEWEWEEWEEWWWWEEEEEEEEWEWEWEWEEEEEEWEWEWEEEWWEWWEEEWWEWWEWEWEWEWEW
WEWEWWWWWEWEEEEEEEEEEEWEEWEWEWEEEEEWEWEWEEEWEWWEWEEWEWEWEWEWEWEWEW
EWEEEEEEEEWWWWWWWWWWEWEEEWEWEWWWWWWEWEWEEEEWEWEWEEEWWEEEWEWEEWWEWE
EWEEEWWEEEEEEEEEEEEEEWEWWEWEWEEEEEEEWEEEEWEEWEEWEEWEEEEEWEWEWEWEWE
EEEEWEWEEEWWWWWWWWWWWEWEWEWEWWWWWWWWEEEEWWEEWEWEEWWEEWWEWEWEWWEEWE
EEEEEWWEEEWEEEEEEEEEEEWEEWEWEEEEEEEEEEEEWEWEEWWEEWEWEWEWEWEWWEWEWW
AWWWEEEEEEWWWWWWWWWWWWEEEWEEWWWWWWWWEEEWEEWEEWEEWEEWEWWEEWWEWWEWWW
