EEEEEEWEEEEA
EEEWEWWEEEEE
EEEWWEWWEEEE
EEEWEEEWEEEE
EEEEWWEEWEEE
EEEEEWWWWWEE
EEEEEEEEWEWW
EEEEEEEEWEWE
EEEEEEEEWWWW
EDEEEEEEEEEE
