EEEEEEEEEEEA
EEEWEEEEEE.E
EEEWWEEEEE.E
EEEWEEEEE.EE
EEEEWWEEE.EE
EEEEEWWW.EEE
EEEEEEEEW.EE
EEEEEEEEW.EE
EEEEEEEEW.EE
ED.......EEE
